Arabic ar
Bulgarian	bg
Czech	cs
Danish	da
Dutch	nl
Finnish	fi
French	fr
German	de
Greek	el
Hungarian	hu
Italian	it
Polish	pl
Portuguese	pt
Romanian	ro
Russian	ru
Serbian	sr
Slovak	sk
Spanish	es
Swedish	sv
Turkish	tr